1111111111111
1001000000C01
1000011111001
1P001100E0011
1111111111111