1111111111111
10010000P0C01
1000P11111001
10001100E0011
1111111111111